   ##   ## #   ########## # # ####     ## # ### ###   ##### 
# #  #   #### #  # # ##  # # ###    #  #####  # # ###  ##  #
########## ### # #### ## #  ###     ######  # ###  # #     #
#       ###  # ###  #### # #   #  ## ##    ###   #    # ####
  #   ##  #  ###  ### ##  ## ## #  #     ####  #   # #    # 
#     ##  ###   #  #  #  #  #      #   # # #   #   # ## #   
  #  ##### ## ## #  # ## # ## ### ## # #  ##    # # # ####  
 ### #   ## #      ####  ### #   ##     # #  # ###      ## #
   #### #    ##  ##    # ### # ##  # ##### ### # ####  ### #
##  # ##  ## ### #    #  ####   ##  #  # ##   # #  #  # ### 
##   #  # ###  # #### ##  ###       ##  #  #   ##  # #    ##
 #    #### ##     ## #  ## ##  ##  ####  ## ## # #   ### # #
## ##   ###    #    ## # ## ###  ##    ####  ## #   #  # ###
  ######### #  #  ## # ##  ### ##   ##  ##  ##### ####  #   
# #    ## # #  ###  ###  ###### ##  # # ### ### #   ###   ##
###  # ## # # #    #  # #  # # # #    ## # #######  #     ##
##      #  ## # #      #   # #  #  ##     ##   ## ##   #   #
  ## # ## #  ## ### ### # ## #  ####  #    ########  # ### #
 # # #### #  ##   ###  ##    #      ##### ### #   # ###   # 
## ## # ### #  # ###  ##  #    ##   # # # # ####    #### ## 
## ## #   ###   ####   ### # #    ##   ###  #    ## ###### #
  #   ####     ## ######   ## ### ###       #    ###   #   #
##   #### ## # ## ###    ## ### ## #     ##  # ### #  # # ##
# #   #  #      # ## #   # ###    #      #  # # # ## ##  ###
#  # ## ## #   # # ### ######## ####  ##### #### ###### # # 
#   ##### # #   #  ###   # #  ## #   ###   #   #    ## # ## 
#  #  # ## ## #  #### # ####   ## ##  ####### # # #    #### 
 ####  ###  ### #   ## ## ##  # # # ###  # ##     ## ###    
 # # ###  # ##  # #   # #  #  #  ##   #   # ## ######  ##  #
    ##   #  ## # # # ## ### ## ##  ## ## # ##  ## # #  #### 
